白	a
向	m
㠯	b
𠂉	r
廾	h
𠂇	f
𠂊	n
𠃊	l
乛	z
𧘇	k
𠂆	p

一	云元示亍亏二三亘豆五乙武
一	正𤴓干平天无旡灭歹互至丐西酉两丽丙再
𤣩	𡈼壬王玉
艹	苗若节莫
廿	甘革堇某
其	甚
耳	取
五	吾
𡗗	奏春
丅	工下
丁	可哥寸才牙
十	古支直真卉孛克南华
木	本未末耒术束柬查来相
米	娄
耂	者老考
土	士圭击志寺赤去吉夌啬
圭	责青
廾	开井升共火业非曹曲韭弗览临亚严昔
丆	石百面页而不丕万死
百	夏
𠂇	友布左右发车东
尢	尤龙
大	太犬夫夹夷奇
厂	原辰历厄
𠂆	𠂢斤斥反质
戊	戌戍成咸
扌	手
匚	区巨臣
c	印卵卯


丨	虫中丰申巾串用韦书甫肃北走
亅	求于隶事
上	止此占卢攴叔卓贞卡步
虍	虎虑
阝	阿
卩	卫
山	出
口	国因只兄吊呆另吕员呙虽吴呈
日	曰旦早易是星
目	且具
罒	罗
田	禺里畏果贯由甲
冂	贝见月周冈同内肉冉丹

丿	片寿尹系我禹么币乏丘
𠂉	乍午牛生朱先失矢乞每告缶𦈢
钅	金
⺮	答
千	禾秀舌垂重
夭	乔
亻	隹你化任
白	臼囱奥自身血囟𠂤舟鸟乌岛卑鬼阜
臼	鼠叟
人	余今令含合舍仓介仑命个俞入臾
八	公分父谷
乂	义丈史吏更女
爫	采爱
𠂊	夕久欠尔鱼刍争色免兔象危角
刍	急
夕	名多祭
夂	㣊夅各冬
勹	勺句勿匆旬匈包匀勾
几	风凡殳朵
儿	兆

丶	斗头州永丫
亠	方亡享亨京亭高言亲产文亢市主玄立衣充商亦衮六交亥
文	齐
立	音
音	竟章
门	问
广	庄鹿店庆库度唐麻
宀	宁宇穴它安定宝官空宜宗完学觉察
丷	半当总兑尚羊兰关弟券卷曾肖单兼
灬	黑
心	必
辶	之
冖	农军
㓁	罕
户	扁

乚	匕也乇毛电曳乜屯七
弋	戈戋㦮戎式尧
巳	巴
匕	比
乛	了孑子皮蛋劲疋孟𠄘甬矛予
𠃍	己已马丑敢镸
𠃊	以
又	叉圣
癶	登
艮	即良民瓦氏氐
尸	局居尺尽尼尾眉屋
彐	灵录
𠃌	习刁司刀刃召那力为办
廴	廷建
𠄎	乃及

纟	幺乡
厶	允台夋参
𠃑	s专与
九	丸