白	a
向	m
㠯	b
𠂉	r
井	h
𠂇	f
𠂊	n
𠃊	l
𠂆	p
光	v
学	w
𠄎	j
𠃑	s
乁	z
哉	g
至	q

一	云元示亏二三豆册
一	𤴓干于平无旡灭不丕死歹互丐西酉两丽丙再开牙
示	禁祭
歹	列
至	到
𤣩	王玉
艹	苗若节莫苟劳荒英带茶萧荃莹莽蒙荣
苟	敬
廿	甘某
革	勒
耳	取耶聂
覀	要票覃
五	吾
丅	工下正
工	巩巧巫
正	焉
不	否
丁	可哥寸才求
十	古支直卉克南华惠妻囊
直	真颠
卉	贲
古	胡故
木	术未本束柬查相林桑析松集
未	来末
耒	耦
束	赖
土	士圭击志寺赤去吉啬卖索走坐袁均坚
圭	责青敖麦表卦
走	起
𠦝	朝翰
孛	勃
士	声壹喜彭
哉	戴截
h	共昔黄韭弗严
共	巽巷其
其	甚斯
丆	石百面页而万
百	夏
𠂇	有友布左右灰发存在
车	斩辇
耂	者老考孝都
尢	尤龙
大	太犬夫夹夷奇夸奄奔奈契
夫	规
𡗗	奏春奉泰秦
厂	原辰历厄厉厥厨厘
辰	辱
戊	戌戍成咸臧戚威
咸	感
七	切
弋	式贰武戒
戈	戎尧或
扌	折执拍
匚	区巨臣匡匝
雨	需雷霸

丨	中丰申巾串韦书肃北
忄	快
中	忠
虫	贵
丰	寿邦
丬	状将
亅	隶事
水	沓
氺	黎
上	止占卢卓贞卡睿
止	此肯步齿
步	频
尗	叔
虍	虎虑虚虏
阝	阿队隐阴
卩	卫
山	出崔岂炭崩岁岑蚩
口	国因困固只兄吊呆另吕员虽吴呈品四回邑
因	恩
另	别
日	曰旦冒昌早旱易是星显明最曼昆替暴景晃
目	且具
且	县助
罒	罗罢署
皿	监
田	畏果贯留胃累思
里	野
異	冀
冂	贝见周冈用同内冉丹
见	览
贝	赞贱则
内	肉
冖	农军冗写冥
㓁	罕
h	师
曲	典
⻊	路
v	党尝肖堂
尚	掌

丿	片系我禹么币乏升
𠂉	乞每乍午矢复气生朱先失告制
每	敏
矢	知
𦈢	卸
钅	金
⺮	答纂算笔
千	舌垂重乘熏
夭	乔
禾	秀委香秋利黍聚秃
委	魏
乇	毛
亻	隹你化任付代何佰保侯候伐便攸倍伦伊休
隹	焦翟
彳	微征行衡
a	囱奥自身血囟𠂤乌丘段
丘	兵
白	泉帛卑鬼皇皆
自	臭息
臼	鼠叟
𠂤	阜
乌	鸟岛
身	射
舟	般
c	印卵卯乐
𠂆	斤反质盾后爪瓜
斤	斥欣
人	央臾从
𠆢	余今令含合舍仓介仑命个俞食会全禽
㐱	翏
今	念
八	公分父谷
公	翁
父	爹
乂	义丈史吏更希杀
爫	采爱奚孚受爵舀妥舜
采	番
𠂊	夕久欠尔鱼刍争色免象角负奂鲁
鱼	鲜
免	兔
角	解
刍	急
夕	名多
夂	各冬务条备处
勹	勺句勿匆旬匈包匀勾匋匍
厃	危詹
几	凡朵
𠘨	风
月	朋滕肋
儿	兆
氏	昏
豸	貌

丶	斗头州永丫之
良	郎
亠	方亡亨京亭高言亲产文亢市主玄立衣商亦衮六交亥卒旁夜辛率帝亶襄豪啇哀禀离雍
文	刘
亡	赢
京	就
方	旋族於
玄	畜
亨	享
享	孰敦郭
𠫓	育充
讠	诸
亦	弯
产	彦
文	齐
立	音童意
音	竟章
亲	新
门	问闰间阁阑闲闷
广	庄鹿店庆库度唐庶府康廉麻庸
麻	靡磨
疒	疾
宀	宁宇穴它安定宝官宜宗完察害家宛客寅宾塞宿容宣审守
穴	窄窜空
冫	次
氵	海溥汤波浦活沙澡潘洛泊
灬	然
丷	并半总兑羊关弟券卷曾单普差益美
关	郑
羊	羔善
㡀	敝
米	娄糕类
羊	羲
屰	朔
䒑	兰兼前酋兹首
酋	尊
兴	誉举挙
心	必
辶	达连逢迷退造追过
户	扁扇
火	炎

乚	匕也电曳乜屯
匕	比顷疑旨
巳	巴
乛	了子皮蛋劲疋孟𠄘甬矛予
孑	孔孙
疋	胥
矛	柔
𤴔	疏
𠃍	己已丑敢
𠃊	以
彑	彖
又	叉圣难的
叉	蚤
癶	登
艮	即既
尸	屈局居尺尽尼尾眉屋辟尉殿刷展属屏
彐	灵录尹
𠃌	习刁司刀力那
习	羽
刀	刃召
力	为办加
廴	廷建延
𠄎	乃
乃	及隽

厶	允台参矣牟
纟	约
幺	幼
𠃑	专与
乁	飞九
九	丸
弓	弘强弱
女	奴如婴姑好
巛	巢
凵	凶函